0  0  0  0  0  0  0  0  0  0  0  0  0   
0  98  1  14  15  14  1  1  1  1  1  1  0   
0  0  0  0  0  0  0  0  0  0  0  1  0   
0  8  1  1  2  1  0  5  6  1  0  1  0   
0  1  12  1  0  1  0  4  8  1  0  1  0   
0  0  2  0  0  1  0  0  0  14  0  1  0   
0  6  1  1  0  1  3  10  11  10  0  1  0   
0  1  13  1  0  1  0  0  0  0  0  1  0   
0  0  2  0  0  1  1  1  1  1  1  1  0   
0  1  1  1  0  0  14  0  0  0  14  0  0   
0  8  1  6  0  7  1  6  0  1  10  1  0   
0  8  1  6  0  1  99  1  0  14  9  14  0   
0  0  0  0  0  0  0  0  0  0  0  0  0  

0  0  0  0  0  0  0  0  0  0  0  0  0 
0  98 0  6  0  15 4  1  0  7  7  7  0
0  1  0  6  0  1  5  1  6  9  8  9  0
0  1  0  7  0  9  13 14 1  0  10 11 0
0  12 0  7  0  12 1  8  10 0  13 1  0
0  11 0  2  0  0  3  11 11 0  0  3  0 
0  1  1  11 12 1  1  0  0  1  1  1  0
0  11 11 1  1  1  1  0  6  1  1  12 0
0  0  0  0  0  3  2  0  1  8  0  11 0
0  13 4  14 0  11 12 0  1  1  0  3  0
0  6  7  11 0  1  1  0  13 1  1  3  0
0  15 5  15 1  1  1  1  1  11 1  97 0
0  0  0  0  0  0  0  0  0  0  0  0  0 

0  0  0  0  0  0  0  0  0  0  0  0  0 
0  1  15 1  14 1  1  15 1  1  1  1  0
0  14 12 1  1  0  0  3  0  0  1  1  0
0  1  4  13 1  0  12 1  13 0  1  7  0
0  11 1  7  1  0  13 1  12 0  6  1  0
0  12 6  1  1  0  1  5  1  0  13 5  0 
0  1  11 1  6  0  1  1  12 0  13 3  0
0  97 1  0  0  0  7  6  1  0  0  2  0
0  1  11 12 1  1  0  14 7  8  1  98 0
0  1  13 13 7  6  0  1  15 12 1  1  0
0  15 8  5  4  7  0  1  5  4  0  9  0
0  14 9  4  5  6  0  7  6  13 0  4  0
0  0  0  0  0  0  0  0  0  0  0  0  0 

0 0  0  0  0  0  0  0  0  0 0  0  0
0 12 12 13 4  1  0  6  15 1 14 12 0
0 11 4  1  8  5  0  7  1  1 12 6  0
0 1  7  1  9  6  0  14 5  5 1  11 0 
0 1  9  1  4  10 0  15 4  7 6  1  0
0 1  1  1  11 3  0  2  8  7 15 98 0
0 0  0  0  0  11 12 13 0  0 0  0  0
0 12 5  7  1  2  0  3  1  1  6 5  0
0 6  1  14 14 11 0  1  12 1 7  6  0
0 13 4  1  4  15 0  4  5  1 1  8  0
0 1  1  12 1  11 0  1  7  8 13 13 0
0 97 1  11 1  8  0  6  5  1 4  14 0
0 0  0  0  0  0  0  0  0  0 0  0  0

0  0  0  0  0  0  0  0  0  0  0  0  0 
0  98 1  14 1  1  1  1  6  1  5  4  0
0  1  1  0  0  0  0  0  0  0  1  12 0
0  13 15 0  3  4  5  6  7  0  1  11 0
0  12 13 0  12 11 10 9  8  0  13 12 0
0  1  1  0  13 14 1  15 3  0  1  1  0
0  1  1  0  7  6  1  5  4  0  1  1  0
0  1  1  0  8  9  1  10 11 0  1  1  0  
0  2  0  0  0  2  3  2  0  0  0  3  0
0  1  9  8  11 13 12 15 11 9  8  1  0
0  1  1  1  1  12 1  13 1  1  1  1  0
0  4  8  4  14 1  97 1  15 5  9  5  0
0  0  0  0  0  0  0  0  0  0  0  0  0

0  0  0  0  0  0  0  0  0  0  0  0  0 
0  5  5  4  5  6  7  8  9  5  6  0  0
0  7  0  0  0  0  2  0  0  0  0  8  0
0  8  0  13 12 11 12 13 14 15 0  8  0
0  4  0  1  11 14 98 1  1  1  0  4  0
0  4  0  11 12 15 15 15 13 1  0  5  0
0  4  2  13 12 11 97 1  12 1  3  6  0
0  5  0  11 1  11 1  1  15 1  6  7  0  
0  6  0  15 1  12 13 14 15 11 0  8  0
0  7  0  14 13 12 14 12 13 15 0  9  0
0  8  0  0  0  0  3  0  0  0  0  9  0
0  9  4  4  5  4  5  6  6  7  7  9  0
0  0  0  0  0  0  0  0  0  0  0  0  0

0  0  0  0  0  0  0  0  0  0  0  0  0 
0  9  11 14 15 0  98 0  11 12 13 11 0
0  8  1  1  13 0  1  0  1  1  1  1  0
0  7  12 13 11 0  11 0  11 1  12 13 0
0  4  6  5  12 2  12 3  5  6  5  6  0
0  0  0  2  0  0  13 0  0  2  0  0  0
0  1 1 1 1 1 1 1 1 1 1  1 0
0  0  0  3  0  0  1  0  0  3  0  0  0  
0  5  4  6  1  2  7  3  4  1  1  1  0
0  1  1  1  1  0  8  0  4  1  13 12 0
0  1  1  4  11 0  1  0  13 1  1  14 0
0  1  1  4  12 0 97 0  14  1  15 15 0
0  0  0  0  0  0  0  0  0  0  0  0  0

0  0  0  0  0  0  0  0  0  0  0  0  0 
0  4  4  8  4  4  5  0  14 13 8  9  0
0  6  5  7  4  6  1  0  1  1  7  12 0
0  2  3  98 1  13 12 0  1  97 1  11 0
0  1  4  0  5  4  6  0  13  9 10 6  0
0  5  1  0  12 13 7  0  15 12 13 1  0
0  6  1  0  12 1  8  0  0  3  2  0  0
0  6  4  0  11 1 14 0  4  11  1  5  0  
0  6  1  0  0  2  0  0  4  1  4  9  0
0  1  4  0  9  1  13 0  5  1  1  1   0
0  6  5  0  11 1 11  2 6  1  5  6   0
0  7  8  3  12 12 13 3  15 4  6  7   0
0  0  0  0  0  0  0  0  0  0  0  0  0

0  0  0  0  0  0  0  0  0  0  0  0  0 
0  11 12 13 14 0  15 11 12 10 0  97 0
0  11 10 15 14 0  13 12 11 10 0 1   0
0  10 11 12 10 0  11 14 11 10 0  1  0
0  11 10 13 11 0 12 12 11 12  0 1 0
0  11 10 13 11 0 12 13 11 12 0 1  0
0  0  0  0  2  0  0  0  3  0   0  1 0
0  1  1  1  1  1  1  1  1  1  0  1  0  
0  2  0  0  0  3  0  0  0  0  0  1   0
0  12 13 14 0  12 11 15 14 13 0 1    0
0  11 15 14 0  13 12 14 15 15  0 1  0
0  13 12 11 0  11 12 13 14 15 0 98   0
0  0  0  0  0  0  0  0  0  0  0  0  0

0  0  0  0  0  0  0  0  0  0  0  0  0 
0  4 6 7 8 4 1 5 6 7 8 9 0
0  5 0 0 0 0 0 0 0 0 0 0   0
0  0 6 5 4 9 8 7 6 5 0 4  0
0  7 8 9 0 0 0 0 4 5 8 9 0
0  0 4 5 6 4 9 8 7 6 6 7  0
0  7 8 0 0 0 0 0 0 0 4 5 0
0  9 4 5 0 6 7 0 8 9 8 9  0  
0  6 7 0 7 6 5 0 4 0 6 7   0
0  8 0 9 8 8 9 0 0 0 4 5    0
0  9 6 4 5 1 1 1 1 5 7 9  0
0  4 5 7 6 7 97 1 1 4 6 8   0
0  0  0  0  0  0  0  0  0  0  0  0  0





